111111111111111111111
1C00000000000000000E1
100000000000000000001
100000000000000000001
100000000000C00000001
100000000000000000001
111111111111111111111