111111111111111111111
1P00000000000000000E1
100000000000000000001
100000000000000000001
100000000000C00000000
100000000000000000001
111111111111111111111