1111111111111111111111111111111111
1P000000000001000000000000000000E1
1110111111011111111011111111101111
10000000000000C0000000000000000011
1011111111111011111111111111111101
10000000000000000C0000000000000001
1111111111111111111111111111111111
