11111
1CCC1
1CCC1
1CCC1
1PEC1
11111