1111111111111111111111111111111111111111111111111
1P00000000000000000000000000000000000000000000001
1010001000111110001111100011111000111110001111101
1010010001000010010000100100001001000010010000101
1010100001111110011111100101111001111110011111101
1010010001000010010000100100001001000010010000101
1010001001000010010000100011111001000010010000101
1000000000000000000000000000000000000000000000001
1000000000000C000000000000000C0000000000000000001
100000000000000000000E000000000000000000000000001
1111111111111111111111111111111111111111111111111